Description: 4x4 chunks, where each chunks is a 10x10 sequence of zeros(empty) or ones(wall)
dimension:4x4
chunk_size:10x10
1111111111111111111111111111111111111111
1010104000100010001010101040000000000011
1010101011101010101010101110111110111011
1000001010101010100000100000400010001011
1011101015101111111010101110111010111111
1010001010101000001010101000001010001011
1110101110101110111010101011111011111011
1000104010000010000010001010004010001011
1110101110111110111111111110111111101011
1010100000001000000010000000001040040011
1010141111111111101111111011101111101111
1000101010000000001000001010101000001011
1010101010101011111110111110101111101011
1014101010101010104000101010101000401011
1111101011111010101110101010101111101011
1010101010001000000010000010001040101011
1010101011101011111011111111111011101011
1000400000000010000010000010001050100011
1010111010111110111110101111101110101011
1010104010100000000020100010100010401011
1111111010111110111111111010111011101111
1014101010100000001000101000000010000011
1010101011101011111011101111111011111011
1000041010101010001010100010040015000011
1110101010111010111010111010111011111011
1000101040100000101000000000101410001011
1110111110101111101011111111101010101011
1040040000101010001010001004101050100011
1111101011111011101110111011101110101111
1000001000101010101000100000100000100011
1111101014101010101110111110141110111111
1000001010100000100000000004000010100011
1011111111111411101010111011111010101011
1000040010050010001010101000100015001011
1011111111101110111110101110111110101011
1010000010101000001010101000140000101011
1111111014101010111010101011101010111011
1300050000000010100000501000101010100011
1111111111111111111111111111111111111011
1111111111111111111111111111111111111111