Description: 4x4 chunks, where each chunks is a 10x10 sequence of zeros(empty) or ones(wall)
dimension:4x4
chunk_size:10x10
0100000001000001000000010001000100000001
0101111101010111010111010101010111110101
0100000100010100010100010100010000010101
0111110111110101110111110111111111010101
0000010100010001010000000000010000010101
0111010101111111011111111101110111111101
0001010100000000000101000101000100000001
0101110101110111110101010111011101110111
0100000100010000010101010100010001010001
0111111111111111010101011101110111011101
0001000000000000010001000001010100010001
1101110111111111111101111111010101010111
0100010100000100000101000000010101010001
0111010101111101010101110101110101011101
0001000100000001010100010101000101010101
0111111101111111011111011101011101010101
0100000101000001000001010001010001000101
0101011101010111110101010111011101111101
0101000001010000010101010100010001000101
0101111111011101010101010101110111010101
0001000100010001010121010101000100010031
0111010111110111010101010101010101111101
0001010000000100010000010000010100000101
1101011111011111111101111111110111110111
0001010000010000000000000100000100010001
0111011111110111110101110111011101111101
0100010000000100010101010001000001000101
0111010111111101011101011101110111010101
0001000001000101000101000101000100010101
1101111101110101110101010101011101110101
0100000100010100010001010001000100010001
0111110111010111011101011111110111011101
0001010001000001010001010000010001010001
0101011101111111011101010111011111011111
0100000101000001000100000101000001000001
0111011101011101010101111101111101111101
0100010001010001010000010100000101000001
0111110111010111111101010101011101011101
0000000000010000000000010001000000010001
1111111111111111111111111111111111111111