Description: 4x4 chunks, where each chunks is a 10x10 sequence of zeros(empty) or ones(wall)
dimension:4x4
chunk_size:10x10
1111111111111111111111111111111111111111
1101111101010111010111010101010111110101
1100000100010100010100010100010000010101
1111110111110101110111110111111111010101
1000010100010001010000000000010000010101
1111010101111111011111111101110111111101
1001010100000000000101000101000100000001
1101110101110111110101010111011101110111
1100000100010000010101010100010001010001
1111111111111111010101011101110111011101
1001000000000000010001000001010100010001
1101110111111111111101111111010101010111
1100010100000100000101000000010101010001
1111010101111101010101110101110101011101
1001000100000001010100010101000101010101
1011111110111111101111101110101110101011
1100000101000001000001010001010001000101
1101011101010111110101010111011101111101
1101000001010000010101010100010001000101
1101111111011101010101010101110111010101
1001000100010001010121010101000100010031
1111010111110111010101010101010101111101
1001010000000100010000010000010100000101
1101011111011111111101111111110111110111
1001010000010000000000000100000100010001
1111011111110111110101110111011101111101
1100010000000100010101010001000001000101
1111010111111101011101011101110111010101
1001000001000101000101000101000100010101
1101111101110101110101010101011101110101
1100000100010100010001010001000100010001
1111110111010111011101011111110111011101
1001010001000001010001010000010001010001
1101011101111111011101010111011111011111
1100000101000001000100000101000001000001
1111011101011101010101111101111101111101
1100010001010001010000010100000101000001
1111110111010111111101010101011101011101
1000000000010000000000010001000000010001
1111111111111111111111111111111111111111