Description: 2x2 chunks, where each chunks is a 10x10 sequence of zeros(empty) or ones(wall)
dimension:2x2
chunk_size:10x10
11111111111111111111
14001000001000101011
11101010101011101411
10001010100010140011
10111411111010101111
10000000100010001011
11111011101111101011
10050000100010000011
11111010111110101011
10000010200000101011
10101011111011151111
10101000101010000011
10101010101111101111
10101010100040000011
10111114101110111011
10004010100010101011
10111011101110101011
10001000104010100011
11111111111111111311
11111111111111111111