Description: 2x2 chunks, where each chunks is a 10x10 sequence of zeros(empty) or ones(wall)
dimension:2x2
chunk_size:10x10
11111111111111111111
10401010000010040011
10111010111110101111
15100010001000104011
10111010111011111111
10000000100000040011
10141011101110101111
10101000100010100011
10101110111011101111
10100010021000101011
14101011111011111411
10101010000010000011
10111010101110101111
10401000101010104011
10111010101010111111
10104010100000100011
10101110101010101111
13100015101010000011
11111111111111111011
11111111111111111111