Description: 3x3 chunks, where each chunks is a 10x10 sequence of zeros(empty) or ones(wall)
dimension:3x3
chunk_size:10x10
111111111111111111111111111111
101010000000100000001000101311
101010101110101110111011101011
100010101010000010000010000011
111010111010111010111010111011
101000100000001010001010100011
101111101010111110111111111011
100010001010000010100000000011
111011111011101111111110111011
100010000010101000100000101011
111011111110101011111111101011
100000000000101000000000001011
101111101111101010111110111011
100000100000020010100000100011
101111101111101011101010111011
101000100010001000001010000011
101010101111101111111111101111
100010100000100000101000001011
111011111111101111101110111011
101010000000100010000010000011
101110111111101110111011101111
100000100000100010001000100011
101111111011111111111110101011
100010001000001000100000101011
111010101011111010111110101111
100000100000001010001000001011
101110111011101011101011101011
101000100000100010000010000011
111111111111111111111111111011
111111111111111111111111111111