Description: 4x4 chunks, where each chunks is a 10x10 sequence of zeros(empty) or ones(wall)
dimension:4x4
chunk_size:10x10
1111111111111111111111111111111111111111
1000000010100010000010001010000000001011
1110111110101011111010111010101111111011
1000100010001000101000001000101010000011
1010101110111111101110101110111011111011
1010000000001010100010100000001000000011
1011111110111010111011111111101010101111
1010000000100010101000000010100010101011
1111111110101010101110101010111110111011
1000101000001000000000101010001000001011
1010101111111010111011101011101010111011
1010101000101010001010101000000010100011
1010101011101111101010111110111110111011
1010000000000000001010000000001000101011
1011111011101111101111101011111011101011
1010000010000010101010001010000010001011
1011101011111110101011111111101010111011
1000101000000010020000000010101000001011
1011111111101111101011101110111110101011
1000100010001000101010100000100000101011
1111111011111011101110111110111010111011
1010000010001000000000001000001010000011
1011111010111110101110101111111110101111
1000100010000000100010100010000010100011
1011111011101110101111101110111011111111
1010000010001010100010000010001010000011
1010111010111011111011111110111010101111
1010101000000000100000100000001010100011
1010101010111111111110101010111010111011
1000100010101010100000001010100000100011
1110111111101010111111111110111111101111
1010100000100000001000001010000010001011
1010111010101011111010111011101110101011
1000001010001000000010001000001010101011
1011101111101010111111101111101011101011
1010000010101010001000101000001000100011
1011101110111010111010111010111010101011
1010000000100010000010000010000010101011
1111111111111111111111111111111111111311
1111111111111111111111111111111111111111