Description: 3x3 chunks, where each chunks is a 10x10 sequence of zeros(empty) or ones(wall)
dimension:3x3
chunk_size:10x10
111111111111111111111111111111
131000501000001010000000400011
101110111010111011111110111111
100010040010000010101000140011
101110101110101110101011111011
100014101000100000101010000011
101111101010111010101011111011
100040001010100010000010401011
111111101111111011111010101011
100000101000000010100004100011
111411111011101110111011111111
101000101000101010101000000011
101010101011111010101011101111
100410000000000000100000141011
101110111111111011101011111011
100010101010000210101000101011
101110101011111010111011101011
104010100010000000401000101011
101110101011111110111111101011
104010101010004000101000000011
101011101111101010101111111011
101010000010501010100010100011
111010111011101011111010111011
100010101010001010101000000011
111010101010111010101011101011
100010100050101010100010001011
101111101110101010101110111011
100010001000104000000010100011
111111111111111111111111111011
111111111111111111111111111111