Description: 4x4 chunks, where each chunks is a 10x10 sequence of zeros(empty) or ones(wall)
dimension:4x4
chunk_size:10x10
1111111111111111111111111111111111111111
1101111101000111000111000111040111110001
1100005000010105010100010000010004000101
1111110111110101110111115111011111010101
1000010100010001010000040000010000010101
1111010101111111011111111101110111111101
1001010100500040000101000101000100040001
1101110101110111110101010101011101110111
1100000100010000010101010100010001010001
1111111111111111010101011101110111011101
1001000500000000010001000001010100010001
1101110111111111111101111111010101010111
1000010100400100050101005000010101010001
1011010101111101010101110101110151011101
1001000100000001010100010101000101010101
1111111101111111011111011101011101014101
1100000101000001050001010001010001000101
1101011101010111110101010111011101111101
1101000001010000010101010105010001000101
1101111111011101010101010101110111010101
1001040100010001010121010101000100014031
1011014111110111010101010101010101111101
1001010000000100010000410000010100040101
1101011111011111111101111111110111110111
1001010000010000004000000100400100010001
1111011111110111110101110111011101111101
1100010050000100010101010001000501000101
1111010111111101011101011101110111010101
1001000001000101000101040101000100010101
1101111101110101110101010101011151110101
1100000100010100010001010001040100010001
1111110111010111011101011111110111011101
1001010001000001010001010000010001010001
1101011101111111011101010111011111011111
1004000101000001000100500101000001000501
1011011101011101010101111101111101111101
1004010501010001010000010100500101000001
1011110111010111111101010101011101011101
1000004000010000005000010001000040010001
1111111111111111111111111111111111111111