1111111111111111111111111111111111111111
1333333300101000101010001000100000100011
1011111311101110101010111110111010101111
1000100310101000000010100000101010100011
1011111310101011111110111011101010101011
1010033300001000000010000010100010001011
1011131111111011101111111010101111111011
1010030000000000100010000000100000001011
1110131111101110101011111010111011101111
1000133333101000101010001010000010001011
1110101013111011111010101111111110111011
1000101013331013331010101000100010000011
1011101111131113131111101010101011111011
1010001000131333130010001010101000000011
1111111110131311131010111110101110111111
1000000010033310131000100010001010100011
1011101111111110131110101111101011101111
1010100010000000130010100010001010000011
1110101111101110131010101110101011101011
1010000010000010021010000010100000101011
1010101111111011111111111011111110111011
1000100000100000000010100000100000101011
1111111011111110111110101111111011101011
1000000000000000100010100000000000100011
1011111111101011101010111111111011101111
1000000010001000101000101010000010000011
1011111110111111101011101011111111101011
1000001010000010101000100000100010001011
1010101010111110101111101010101111101111
1010101000001010100010101010100010001011
1111111011101010101110101111111010111011
1000000010000000101000001000000010000011
1111111111111110101111101111101110111011
1000001010101010001000100000001000101011
1011111010101011101110111111101110101011
1000001000000010000000001010000000001011
1110111011101110111111101010111110111011
1000000000100000000010000000001000001011
1111111111111111111111111111111111111011
1111111111111111111111111111111111111111