Description: 3x3 chunks, where each chunks is a 10x10 sequence of zeros(empty) or ones(wall)
dimension:3x3
chunk_size:10x10
111111111111111111111111111111
101040100010000000400000101011
101010101111111111101010101011
101010000000001000141010100011
101111101111111010101011101111
100040000000001010001000100011
111011101011111111101110101111
101040101000001000100010100011
101011101011111110101111111011
101000101000000002000000100011
101111111111111010111110101111
100004000000000010100000141011
101111111010111110111111101011
100010001010000010000000100011
111011101010101110101110101011
101010000010101000101010001011
101010101011111111111010111111
101010101010001010001000101011
101011111110111011101011101011
101010101404100000000510001011
101010101110111010101010101011
101010000000001010101010100011
101011101110111011111011111011
100400000010100010100000001011
101111111011111010111111101011
100010101000001000100010000011
101110101011111111101011101011
100000100400000000101000001011
111111111111111111111111111311
111111111111111111111111111111
