Description: 3x3 chunks, where each chunks is a 10x10 sequence of zeros(empty) or ones(wall)
dimension:3x3
chunk_size:10x10
111111111111111111111111111111
101040000000400010001010001011
101011101111111010111010111011
100010100010000010101010000011
101010111111111110101010111011
101000001000004000001010001011
111110111110101011111010111111
100400001000101010000004100011
101011101011101111101111101011
101000150000101010000000001011
111011111011111011111110101011
100400001000101000101000101011
111011101010101010101411101011
101000101010001010100010101011
101111101110121010101010111111
100000104010100010001000000011
101011101111101110111111101011
101410100010100010000040101011
111010111110101110111011101011
101000100010101010100010001011
101010101110101011111011111111
100010400000000010000040000011
111011101110111011111011111111
100000100010001010101000000011
101110111011111110101110111111
101005100010000000000400000011
101111111010101111111011111011
130010000510100010000000100011
111111111111111111111111111011
111111111111111111111111111111
