Description: 4x4 chunks, where each chunks is a 10x10 sequence of zeros(empty) or ones(wall)
dimension:4x4
chunk_size:10x10
1111111111111111111111111111111111111111
1000040010100010040010001010040000001011
1110111110101011111010111010101111111011
1000100010001000101000001000101010000011
1010101110111111101110101110111011111011
1010040000001010100010104004001000000011
1011111110111010111011111111101010101111
1010050000100010101000050010100010101011
1111111110101010101110101010111110111011
1000101400001000040000101010001004001011
1010101111111010111011101011101010111011
1010101000101010001010101000000010100011
1010101011101111101010111110111110111011
1010000000500000001010000000501000101011
1011111011101111101111101011111011101011
1010400010000010101010001010000010001011
1011101011111110101011111111101010111011
1000101005000010020000000410101004001011
1011111111101111101011101110111110101011
1000100010001000101010100000100000101011
1111111011111011101110111110111010111011
1010040010001000050000001000001010000011
1011111010111110101110101111111110101111
1000104010000000104010100010000010100011
1011111011101110101111101110111011111111
1010000010001010100010000010001010000011
1010111010111011111011111110111010101111
1010101005000000100000100000401010100011
1010101010111111111110101010111010111011
1000100010101010100005001010100000100011
1110111111101010111111111110111111101111
1010100000100005001000001010040010001011
1010111010101011111010111011101110101011
1000001010001000000010001000001010101011
1011101111101010111111101111101011101011
1010000010101010401000101000001000105011
1011101110111010111010111010111010101011
1010000500100010000010000010000010101011
1111111111111111111111111111111111111311
1111111111111111111111111111111111111111