Description: 2x2 chunks, where each chunks is a 10x10 sequence of zeros(empty) or ones(wall)
dimension:2x2
chunk_size:10x10
11111111111111111111
10101000401010001311
10101011101011101011
10151010000010000011
10101111111011101111
10000010000010041011
11111010111010101011
10400000101010100011
11101111121111101011
10040010001000001011
11111011101011111111
10100000100000104011
10151011111011101111
10101010100010100011
10101110101110101011
10000010100010041011
11101110111011101111
10004000000000000011
11111111111111111011
11111111111111111111