Description: 4x4 chunks, where each chunks is a 10x10 sequence of zeros(empty) or ones(wall)
dimension:4x4
chunk_size:10x10
1111111111111111111111111111111111111111
1000001010000010000000100010000000001311
1110111011101111111110111010111111101011
1010100000100000001000001010001010100011
1010101010101110111110101010101010111011
1000001010101010100000101000100010000011
1011101111101010111110101110111011101011
1010100000101000001010100010100010001011
1010101011101010111010111111111011111111
1000101010001010000000001000000000001011
1110111110101111111110111111101011101011
1000000010101000001000101000001000100011
1110101111101010101111101110111111111111
1000100010100010100000101000100010000011
1111101010111011101110101110111011101111
1000101000001000100010000010100010000011
1010111110111011111110101110101111111011
1010101000000200001000100000000010000011
1011101110111010101111111011111010101111
1000000000001010101000000010001010100011
1010111010111111111111111010101010111111
1010100010001010100010000010100010100011
1010111110101010111011111111101010111011
1010100010101000000010001010101000000011
1010101111101110111111101010101110111011
1010101010000010001000000000101000001011
1011101010111011101011101011111011111011
1000100000100010001010101000000000001011
1110111011101111101010111011101011111011
1010001010000010001010101000101010001011
1010111010111111101110101110101011101111
1000100010100000000000000000101010001011
1110101111101110111011111011111010101011
1010100010000010100010001000100000100011
1011101110101110111110111011101010111011
1000100010100010101000101000101010100011
1010101110111011101010101011101011101111
1010000010001000100010000010001000100011
1111111111111111111111111111111111111011
1111111111111111111111111111111111111111