1011111111111111111111111111111111111111
1000000010100010000010001010000000001011
1110111110101011111010111010101111111011
1000100010001000101000001000101010000011
1010101110111111101110101110111011111011
1010000000001010100010100000001000000011
1011111110111010111011111111101010101111
1010000000100010101000000010100010101011
1111111110101010101110101010111110111011
1000101000001000000000101010001000001011
1010101111111010111011101011101010111011
1010101000101010001010101000000010100011
1010101011101111101010111110111110111011
1010000000000000001010000000001000101011
1011111011101111101111101011111011101011
1010000010000010101010001010000010001011
1011101011111110101011111111101010111011
1000101000000010020000000010101000001011
1011111111101111131011101110111110101011
1000100010001000131010100000100000101011
1111111011111011131110111110111010111011
1010000010001000030000001000001010000011
1011111010111110131110101111111110101111
1000100010000000130010100013333310100011
1011111011101110131111101113111311111111
1010000010001010133310000013001313330011
1010111010111011111311111113111313131111
1010101000000000100333133333001313133311
1010101010111111111113131010111313111311
1000100010101010100003331010100333133311
1110111111101010111111111110111111131111
1010100000100000001000001010000010031011
1010111010101011111010111011101110131011
1000001010001000000010001000001010131011
1011101111101010111111101111101011131011
1010000010101010001000101000001000133311
1011101110111010111010111010111010101311
1010000000100010000010000010000010101311
1111111111111111111111111111111111111311
1111111111111111111111111111111111111311