Description: 4x4 chunks, where each chunks is a 10x10 sequence of zeros(empty) or ones(wall)
dimension:4x4
chunk_size:10x10
1111111111111111111111111111111111111111
1010100000100010001010101000000000000011
1010101011101010101010101110111110111011
1000001010101010100000100000000010001011
1011101010101111111010101110111010111111
1010001010101000001010101000001010001011
1110101110101110111010101011111011111011
1000100010000010000010001010000010001011
1110101110111110111111111110111111101011
1010100000001000000010000000001000000011
1010101111111111101111111011101111101111
1000101010000000001000001010101000001011
1010101010101011111110111110101111101011
1010101010101010100000101010101000001011
1111101011111010101110101010101111101011
1010101010001000000010000010001000101011
1010101011101011111011111111111011101011
1000000000000010000010000010001000100011
1010111010111110111110101111101110101011
1010100010100000000020100010100010001011
1111111010111110111111111010111011101111
1010101010100000001000101000000010000011
1010101011101011111011101111111011111011
1000001010101010001010100010000010000011
1110101010111010111010111010111011111011
1000101000100000101000000000101010001011
1110111110101111101011111111101010101011
1000000000101010001010001000101000100011
1111101011111011101110111011101110101111
1000001000101010101000100000100000100011
1111101010101010101110111110101110111111
1000001010100000100000000000000010100011
1011111111111011101010111011111010101011
1000000010000010001010101000100010001011
1011111111101110111110101110111110101011
1010000010101000001010101000100000101011
1111111010101010111010101011101010111011
1300000000000010100000001000101010100011
1111111111111111111111111111111111111011
1111111111111111111111111111111111111111