Description: 3x3 chunks, where each chunks is a 10x10 sequence of zeros(empty) or ones(wall)
dimension:3x3
chunk_size:10x10
111111111111111111111111111111
101014000000100040001000101311
101010101110101110111011101011
100010101010000010004010500011
111014111010111010111010111011
101000100000001010001010100011
101111101010111110111111111011
100010001010000010100000500011
111411111011101111111110111011
100010000010101000100000101011
111011111110101011111111101011
100040000000101000000000041011
101111101111101010111110111011
100000100000020010100000100011
101111101111101011101010111011
101040100010001000001014000011
101010101111101111111111101111
100010100000100000101000001011
111011111111101111101110111011
101014000000100010000010000011
101110111111101110111011101111
100000140000100010001500104011
101111111011111111111110101011
100014001000001000100000101011
111010101011111010111110101111
100004100000001010001000001011
101110111011101011101011101011
101000150000100010000010005011
111111111111111111111111111011
111111111111111111111111111111