Description: 2x2 chunks, where each chunks is a 10x10 sequence of zeros(empty) or ones(wall)
dimension:2x2
chunk_size:10x10
11111111111111111111
10001000001000101011
11101010101011101011
10001010100010100011
10111011111010101111
10000000100010001011
11111011101111101011
10000000100010000011
11111010111110101011
10000010200000101011
10101011111011101111
10101000101010000011
10101010101111101111
10101010100000000011
10111110101110111011
10000010100010101011
10111011101110101011
10001000100010100011
11111111111111111311
11111111111111111111