Description: 2x2 chunks, where each chunks is a 10x10 sequence of zeros(empty) or ones(wall)
dimension:2x2
chunk_size:10x10
11111111111111111111
13000010001010001011
11101010101010111011
10001000100010100011
11111110111010101111
10101000100000000011
10101110111011111011
10100000100010000011
10111011111111111111
10000000200000101011
11111111111110101011
10000000001010101011
11111110111010101011
10001000100000101011
11101010101010101011
10000010001010000011
10111111111010101111
10000000100010100011
11111111111111111011
11111111111111111111