Description: 2x2 chunks, where each chunks is a 10x10 sequence of zeros(empty) or ones(wall)
dimension:2x2
chunk_size:10x10
11111111111111111111
10000000000010000011
10111110111011111011
10000010100010100011
10101010111010101011
13101010100010001011
11101110101010111011
10001000101000001011
10111011101011101111
10100010121010101011
10111110111010111011
10001000101000000011
11101010101110101111
10100010001010100011
10101111111011111111
10001010100000000011
10101010101011101011
10100000001010001011
11111111111111111011
11111111111111111111