Description: 3x3 chunks, where each chunks is a 10x10 sequence of zeros(empty) or ones(wall)
dimension:3x3
chunk_size:10x10
111111111111111111111111111111
130000001000000000101000001011
101010111010101111101011111011
101010000010101010100010100011
101110101011101010111010101111
101010101010100000001010100011
111011101110111011101010101111
100000101010100010101000001011
101110111010111110101111101011
101010101000100000000010000011
101011101110101110101011101011
100010001010000010101010001011
101111101011111110101110111011
100000100000001000101010001011
111110101110111010111011111011
100010001000020010100010000011
111011101110111011111010101011
100010001010001000000010101011
111011111011101111111011101111
100000000010100000101010100011
111110111110111010101010101011
100010000000001010101000001011
111011101111111110101011101111
101000001000100000001010001011
101110101011101111101010101011
100010100000100000101010100011
111011111110101111111011111111
100000000000000010000000000011
111111111111111111111111111011
111111111111111111111111111111
