Description: 1x1 chunks, where each chunks is a 10x3 sequence of zeros(empty) or ones(wall)
dimension:1x2
chunk_size:10x10
1111111111
1000000001
1111011111
0001010000
0001010000
0001010000
0001010000
0001010000
0001010000
0001010000
1111011111
1200000031
1111011111
0001410000
0001410000
0001010000
0001010000
0001110000
0000000000
0000000000
