Description: 2x2 chunks, where each chunks is a 10x10 sequence of zeros(empty) or ones(wall)
dimension:2x2
chunk_size:10x10
11111111111111111111
10001010000010000011
10111010111110101111
10100010001000100011
10111010111011111111
10000000100000000011
10101011101110101111
10101000100010100011
10101110111011101111
10100010021000101011
10101011111011111011
10101010000010000011
10111010101110101111
10001000101010100011
10111010101010111111
10100010100000100011
10101110101010101111
13100010101010000011
11111111111111111011
11111111111111111111